Actual map for testing
a##############a
#a############a#
##a##########a##
###a########a###
####a######a####
#####a####a#####
######a##a######
#######aa#######
#b#b#b#b#b#b#b#b
b#b#b#b#b#b#b#b#
#b#b#b#b#b#b#b#b
b#b#b#b#b#b#b#b#
cc##cc##cc##cc##
##cc##cc##cc##cc
abc##########cba
###abc####cba###
######abba######
################
######d##d######